4 4
# S 4 3
# 2 1 #
G 2 # #
# # # #
9 9
# 4 3 2 S 2 2 4 # #
# 5 2 # # # 5 4 1 # 
# 6 1 1 3 4 1 # 3 #
# 5 # # 2 # 1 # 3 #
# 3 # # 2 # 2 # 6 #
# 2 # # 2 # 1 3 4 4
# 2 1 3 4 # 1 # # 5
# 3 # # 3 2 1 # # 3
# 2 # # # # 1 # 2 2  
# 1 2 2 1 1 G # 1 #
2 2
# S
G 1

